00001111110000000000
00001111110000000000
00223455430011110000
00265575550011110000
00228888882255340000
00228888882657550000
00888888888888888899
00888888888888888899
88888888868888888899
88888888888888888899
22888888888888888899
00111188888888882000
00557588888888882000
FF888888221111882000
FF222288265755882000
00888888888888888899
00000088888888888899
00000000000000000000
00000000000000000000